BBBBBBBBBB
B....T...B
B..B...T.B
B.T.S.B.TB
B...T..TBB
BBBBBBBBBB